Solastanomicon/&DwarfFemaleName10Title	Dearma
Solastanomicon/&DwarfFemaleName11Title	Jenrin
Solastanomicon/&DwarfFemaleName12Title	Nisleen
Solastanomicon/&DwarfFemaleName13Title	Misnan
Solastanomicon/&DwarfFemaleName14Title	Jenndora
Solastanomicon/&DwarfFemaleName15Title	Renmera
Solastanomicon/&DwarfFemaleName16Title	Nasnyl
Solastanomicon/&DwarfFemaleName17Title	Brallesyl
Solastanomicon/&DwarfFemaleName18Title	Torthiel
Solastanomicon/&DwarfFemaleName19Title	Myrnera
Solastanomicon/&DwarfFemaleName20Title	Bretri
Solastanomicon/&DwarfFemaleName21Title	Abagtha
Solastanomicon/&DwarfFemaleName22Title	Bera
Solastanomicon/&DwarfFemaleName23Title	Birsha
Solastanomicon/&DwarfFemaleName24Title	Clauda
Solastanomicon/&DwarfFemaleName25Title	Dabareh
Solastanomicon/&DwarfFemaleName26Title	Demelza
Solastanomicon/&DwarfFemaleName27Title	Dodai
Solastanomicon/&DwarfFemaleName28Title	Dura
Solastanomicon/&DwarfFemaleName29Title	Gath
Solastanomicon/&DwarfFemaleName30Title	Hadar
Solastanomicon/&DwarfFemaleName31Title	Hagar
Solastanomicon/&DwarfFemaleName32Title	Halah
Solastanomicon/&DwarfFemaleName33Title	Hanan
Solastanomicon/&DwarfFemaleName34Title	Iddo
Solastanomicon/&DwarfFemaleName35Title	Juttah
Solastanomicon/&DwarfFemaleName36Title	Melea
Solastanomicon/&DwarfFemaleName37Title	Meribah
Solastanomicon/&DwarfFemaleName38Title	Obal
Solastanomicon/&DwarfFemaleName39Title	Peleg
Solastanomicon/&DwarfFemaleName40Title	Ramah
Solastanomicon/&DwarfFemaleName41Title	Sarai
Solastanomicon/&DwarfFemaleName9Title	Bronnura
Solastanomicon/&DwarfMaleName10Title	Gergrom 
Solastanomicon/&DwarfMaleName11Title	Granren
Solastanomicon/&DwarfMaleName12Title	Thurdram
Solastanomicon/&DwarfMaleName13Title	Grilgarn
Solastanomicon/&DwarfMaleName14Title	Doldahr
Solastanomicon/&DwarfMaleName15Title	Vongram
Solastanomicon/&DwarfMaleName16Title	Balmar
Solastanomicon/&DwarfMaleName17Title	Thalmor
Solastanomicon/&DwarfMaleName18Title	Thendrar
Solastanomicon/&DwarfMaleName19Title	Kramgrim
Solastanomicon/&DwarfMaleName20Title	Grilthrum
Solastanomicon/&DwarfMaleName21Title	Abaddon
Solastanomicon/&DwarfMaleName22Title	Adar
Solastanomicon/&DwarfMaleName23Title	Agur
Solastanomicon/&DwarfMaleName24Title	Barabbas
Solastanomicon/&DwarfMaleName25Title	Beor
Solastanomicon/&DwarfMaleName26Title	Bildad
Solastanomicon/&DwarfMaleName27Title	Charran
Solastanomicon/&DwarfMaleName28Title	Dagon
Solastanomicon/&DwarfMaleName29Title	Dor
Solastanomicon/&DwarfMaleName30Title	Ebed
Solastanomicon/&DwarfMaleName31Title	Ezra
Solastanomicon/&DwarfMaleName32Title	Gareb
Solastanomicon/&DwarfMaleName33Title	Gozan
Solastanomicon/&DwarfMaleName34Title	Hadrach
Solastanomicon/&DwarfMaleName35Title	Haggai
Solastanomicon/&DwarfMaleName36Title	Haggeri
Solastanomicon/&DwarfMaleName37Title	Jorah
Solastanomicon/&DwarfMaleName38Title	Medan
Solastanomicon/&DwarfMaleName39Title	Obadiah
Solastanomicon/&DwarfMaleName40Title	Shobab
Solastanomicon/&DwarfMaleName41Title	Sorek
Solastanomicon/&DwarfMaleName42Title	Ziklag
Solastanomicon/&DwarfSurName10Title	Deeprock
Solastanomicon/&DwarfSurName11Title	Flintbrew
Solastanomicon/&DwarfSurName12Title	Onyxheart
Solastanomicon/&DwarfSurName13Title	Ingotbuster
Solastanomicon/&DwarfSurName14Title	Oakenbrand
Solastanomicon/&DwarfSurName15Title	Caskbender
Solastanomicon/&DwarfSurName16Title	Duskhood
Solastanomicon/&DwarfSurName17Title	Magmapike
Solastanomicon/&DwarfSurName18Title	Ashmaul
Solastanomicon/&DwarfSurName19Title	Flintmail
Solastanomicon/&DwarfSurName20Title	Wargranite
Solastanomicon/&DwarfSurName8Title	Trollfury
Solastanomicon/&DwarfSurName9Title	Greyforged
Solastanomicon/&ElfFemaleName17Title	Lythienne
Solastanomicon/&ElfFemaleName18Title	Nanthaliene
Solastanomicon/&ElfFemaleName19Title	Ilythyrra
Solastanomicon/&ElfFemaleName20Title	Ildilyntra
Solastanomicon/&ElfFemaleName21Title	Abdiel
Solastanomicon/&ElfFemaleName22Title	Adiel
Solastanomicon/&ElfFemaleName23Title	Cilicia
Solastanomicon/&ElfFemaleName24Title	Dalmanutha
Solastanomicon/&ElfFemaleName25Title	Eliah
Solastanomicon/&ElfFemaleName26Title	Gaddiel
Solastanomicon/&ElfFemaleName27Title	Galatia
Solastanomicon/&ElfFemaleName28Title	Hena
Solastanomicon/&ElfFemaleName29Title	Hermogenes
Solastanomicon/&ElfFemaleName30Title	Illyricum
Solastanomicon/&ElfFemaleName31Title	Ithiel
Solastanomicon/&ElfFemaleName32Title	Jahdiel
Solastanomicon/&ElfFemaleName33Title	Jehezekel
Solastanomicon/&ElfFemaleName34Title	Lycaonia
Solastanomicon/&ElfFemaleName35Title	Lydda
Solastanomicon/&ElfFemaleName36Title	Maranatha
Solastanomicon/&ElfFemaleName37Title	Mysia
Solastanomicon/&ElfFemaleName38Title	Othniel
Solastanomicon/&ElfFemaleName39Title	Samariah
Solastanomicon/&ElfFemaleName40Title	Sisera
Solastanomicon/&ElfMaleName14Title	Isilynor
Solastanomicon/&ElfMaleName15Title	Alosrin
Solastanomicon/&ElfMaleName16Title	Gaeleath
Solastanomicon/&ElfMaleName17Title	Nueleth
Solastanomicon/&ElfMaleName18Title	Ruvaen
Solastanomicon/&ElfMaleName19Title	Avourel
Solastanomicon/&ElfMaleName20Title	Silvyr
Solastanomicon/&ElfMaleName21Title	Ananias
Solastanomicon/&ElfMaleName22Title	Dathan
Solastanomicon/&ElfMaleName23Title	Eldad
Solastanomicon/&ElfMaleName24Title	Elidad
Solastanomicon/&ElfMaleName25Title	Enochiel
Solastanomicon/&ElfMaleName26Title	Eshbanil
Solastanomicon/&ElfMaleName27Title	Ethamiel
Solastanomicon/&ElfMaleName28Title	Fortunatus
Solastanomicon/&ElfMaleName29Title	Habakkuk
Solastanomicon/&ElfMaleName30Title	Hammelech
Solastanomicon/&ElfMaleName31Title	Hamutal
Solastanomicon/&ElfMaleName32Title	Hazeroth
Solastanomicon/&ElfMaleName33Title	Hymeneus
Solastanomicon/&ElfMaleName34Title	Ibzan
Solastanomicon/&ElfMaleName35Title	Jozachar
Solastanomicon/&ElfMaleName36Title	Lysias
Solastanomicon/&ElfMaleName37Title	Magdiel
Solastanomicon/&ElfMaleName38Title	Mithredath
Solastanomicon/&ElfMaleName39Title	Rehoboam
Solastanomicon/&ElfMaleName40Title	Timnah
Solastanomicon/&ElfSurName18Title	Neridithas
Solastanomicon/&ElfSurName19Title	Neriwenys
Solastanomicon/&ElfSurName20Title	Moryra
Solastanomicon/&HalfElfFemaleName10Title	Barbara
Solastanomicon/&HalfElfFemaleName11Title	Dawn
Solastanomicon/&HalfElfFemaleName12Title	Harriet
Solastanomicon/&HalfElfFemaleName13Title	Thasinia
Solastanomicon/&HalfElfFemaleName14Title	Ellarian
Solastanomicon/&HalfElfFemaleName15Title	Sariandi
Solastanomicon/&HalfElfFemaleName16Title	Aleesia
Solastanomicon/&HalfElfFemaleName17Title	Ahrendue
Solastanomicon/&HalfElfFemaleName18Title	Gylledhia
Solastanomicon/&HalfElfFemaleName19Title	Lucette
Solastanomicon/&HalfElfFemaleName20Title	Isarrel
Solastanomicon/&HalfElfFemaleName21Title	Delilah
Solastanomicon/&HalfElfFemaleName22Title	Rose
Solastanomicon/&HalfElfFemaleName23Title	Juliette
Solastanomicon/&HalfElfFemaleName24Title	Elaine
Solastanomicon/&HalfElfFemaleName25Title	Celia
Solastanomicon/&HalfElfFemaleName26Title	Elisa
Solastanomicon/&HalfElfFemaleName27Title	Ophelie
Solastanomicon/&HalfElfFemaleName28Title	Adalia
Solastanomicon/&HalfElfFemaleName29Title	Candace
Solastanomicon/&HalfElfFemaleName30Title	Claudia
Solastanomicon/&HalfElfFemaleName31Title	Deborah
Solastanomicon/&HalfElfFemaleName32Title	Diana
Solastanomicon/&HalfElfFemaleName33Title	Drusilla
Solastanomicon/&HalfElfFemaleName34Title	Elisha
Solastanomicon/&HalfElfFemaleName35Title	Elizabeth
Solastanomicon/&HalfElfFemaleName36Title	Esther
Solastanomicon/&HalfElfFemaleName37Title	Jesse
Solastanomicon/&HalfElfFemaleName38Title	Julia
Solastanomicon/&HalfElfFemaleName39Title	Leah
Solastanomicon/&HalfElfFemaleName40Title	Lilith
Solastanomicon/&HalfElfFemaleName41Title	Lydda
Solastanomicon/&HalfElfFemaleName42Title	Lydia
Solastanomicon/&HalfElfFemaleName43Title	Naomi
Solastanomicon/&HalfElfFemaleName44Title	Priscilla
Solastanomicon/&HalfElfFemaleName45Title	Rachel
Solastanomicon/&HalfElfFemaleName6Title	Calarel
Solastanomicon/&HalfElfFemaleName7Title	Syndra
Solastanomicon/&HalfElfFemaleName8Title	Kindreth
Solastanomicon/&HalfElfFemaleName9Title	Estrid
Solastanomicon/&HalfElfMaleName11Title	William
Solastanomicon/&HalfElfMaleName12Title	Ben
Solastanomicon/&HalfElfMaleName13Title	Jan
Solastanomicon/&HalfElfMaleName14Title	Illendir
Solastanomicon/&HalfElfMaleName15Title	Iolas
Solastanomicon/&HalfElfMaleName16Title	Gaspar
Solastanomicon/&HalfElfMaleName17Title	Bronwyn
Solastanomicon/&HalfElfMaleName18Title	Anakiir
Solastanomicon/&HalfElfMaleName19Title	Ian
Solastanomicon/&HalfElfMaleName20Title	Edwin
Solastanomicon/&HalfElfMaleName21Title	Dean
Solastanomicon/&HalfElfMaleName22Title	Michael
Solastanomicon/&HalfElfMaleName23Title	Robert
Solastanomicon/&HalfElfMaleName24Title	Aaron
Solastanomicon/&HalfElfMaleName25Title	Adam
Solastanomicon/&HalfElfMaleName26Title	Daniel
Solastanomicon/&HalfElfMaleName27Title	Dothan
Solastanomicon/&HalfElfMaleName28Title	Eli
Solastanomicon/&HalfElfMaleName29Title	Enos
Solastanomicon/&HalfElfMaleName30Title	Ephraim
Solastanomicon/&HalfElfMaleName31Title	Ethan
Solastanomicon/&HalfElfMaleName32Title	Gabriel
Solastanomicon/&HalfElfMaleName33Title	Gideon
Solastanomicon/&HalfElfMaleName34Title	Jacob
Solastanomicon/&HalfElfMaleName35Title	John
Solastanomicon/&HalfElfMaleName36Title	Linus
Solastanomicon/&HalfElfMaleName37Title	Luke
Solastanomicon/&HalfElfMaleName38Title	Mark
Solastanomicon/&HalfElfMaleName39Title	Mason
Solastanomicon/&HalfElfMaleName40Title	Matthias
Solastanomicon/&HalfElfMaleName41Title	Nicolas
Solastanomicon/&HalfElfMaleName42Title	Silas
Solastanomicon/&HalfElfSurName14Title	Forechaser
Solastanomicon/&HalfElfSurName15Title	Loralana
Solastanomicon/&HalfElfSurName16Title	Greenfeather
Solastanomicon/&HalfElfSurName17Title	Windflower
Solastanomicon/&HalfElfSurName18Title	Sparrow
Solastanomicon/&HalfElfSurName19Title	Darksight
Solastanomicon/&HalfElfSurName20Title	Colton
Solastanomicon/&HalflingFemaleName10Title	Darni
Solastanomicon/&HalflingFemaleName11Title	Vada
Solastanomicon/&HalflingFemaleName12Title	Maryola
Solastanomicon/&HalflingFemaleName13Title	Qirana
Solastanomicon/&HalflingFemaleName14Title	Odine
Solastanomicon/&HalflingFemaleName15Title	Trynola
Solastanomicon/&HalflingFemaleName16Title	Syllie
Solastanomicon/&HalflingFemaleName17Title	Yosys
Solastanomicon/&HalflingFemaleName18Title	Harana
Solastanomicon/&HalflingFemaleName19Title	Marri
Solastanomicon/&HalflingFemaleName20Title	Therwyse
Solastanomicon/&HalflingFemaleName21Title	Asriella
Solastanomicon/&HalflingFemaleName22Title	Bilshan
Solastanomicon/&HalflingFemaleName23Title	Carmi
Solastanomicon/&HalflingFemaleName24Title	Darda
Solastanomicon/&HalflingFemaleName25Title	Dibri
Solastanomicon/&HalflingFemaleName26Title	Eden
Solastanomicon/&HalflingFemaleName27Title	Evi
Solastanomicon/&HalflingFemaleName28Title	Gabbatha
Solastanomicon/&HalflingFemaleName29Title	Gilboa
Solastanomicon/&HalflingFemaleName30Title	Hazael
Solastanomicon/&HalflingFemaleName31Title	Hophni
Solastanomicon/&HalflingFemaleName32Title	Igdaliah
Solastanomicon/&HalflingFemaleName33Title	Matri
Solastanomicon/&HalflingFemaleName34Title	Minni
Solastanomicon/&HalflingFemaleName35Title	Myra
Solastanomicon/&HalflingFemaleName36Title	Nekoda
Solastanomicon/&HalflingFemaleName37Title	Pisidia
Solastanomicon/&HalflingFemaleName38Title	Rhesa
Solastanomicon/&HalflingFemaleName39Title	Riblah
Solastanomicon/&HalflingFemaleName40Title	Tebaliah
Solastanomicon/&HalflingFemaleName41Title	Zemira
Solastanomicon/&HalflingFemaleName8Title	Vadrey
Solastanomicon/&HalflingFemaleName9Title	Leora
Solastanomicon/&HalflingMaleName10Title	Perder
Solastanomicon/&HalflingMaleName11Title	Anrin
Solastanomicon/&HalflingMaleName12Title	Corser
Solastanomicon/&HalflingMaleName13Title	Riclos
Solastanomicon/&HalflingMaleName14Title	Belrin
Solastanomicon/&HalflingMaleName15Title	Flynnan
Solastanomicon/&HalflingMaleName16Title	Janvias
Solastanomicon/&HalflingMaleName17Title	Valver
Solastanomicon/&HalflingMaleName18Title	Idopos
Solastanomicon/&HalflingMaleName19Title	Barpos
Solastanomicon/&HalflingMaleName20Title	Quinmo
Solastanomicon/&HalflingMaleName21Title	Alpheus
Solastanomicon/&HalflingMaleName22Title	Apollyon
Solastanomicon/&HalflingMaleName23Title	Arphaxad
Solastanomicon/&HalflingMaleName24Title	Barnabus
Solastanomicon/&HalflingMaleName25Title	Bartholomew
Solastanomicon/&HalflingMaleName26Title	Cephas
Solastanomicon/&HalflingMaleName27Title	Cornelius
Solastanomicon/&HalflingMaleName28Title	Crispus
Solastanomicon/&HalflingMaleName29Title	Erastus
Solastanomicon/&HalflingMaleName30Title	Ezekial
Solastanomicon/&HalflingMaleName31Title	Felix
Solastanomicon/&HalflingMaleName32Title	Gallio
Solastanomicon/&HalflingMaleName33Title	Haman
Solastanomicon/&HalflingMaleName34Title	Hiram
Solastanomicon/&HalflingMaleName35Title	Ichabod
Solastanomicon/&HalflingMaleName36Title	Nehemiah
Solastanomicon/&HalflingMaleName37Title	Nicodemus
Solastanomicon/&HalflingMaleName38Title	Sergius
Solastanomicon/&HalflingMaleName39Title	Tabor
Solastanomicon/&HalflingMaleName40Title	Thaddeus
Solastanomicon/&HalflingMaleName41Title	Zebadiah
Solastanomicon/&HalflingMaleName42Title	Zerubbabel
Solastanomicon/&HalflingMaleName7Title	Sharbin
Solastanomicon/&HalflingMaleName8Title	Valumo
Solastanomicon/&HalflingMaleName9Title	Vinrin
Solastanomicon/&HalflingSurName10Title	Tealeaf
Solastanomicon/&HalflingSurName11Title	Underbough
Solastanomicon/&HalflingSurName12Title	Brushgather
Solastanomicon/&HalflingSurName13Title	Talltalker
Solastanomicon/&HalflingSurName14Title	Fatflower
Solastanomicon/&HalflingSurName15Title	Greatfellow
Solastanomicon/&HalflingSurName16Title	Ostgood
Solastanomicon/&HalflingSurName17Title	Hornblower
Solastanomicon/&HalflingSurName18Title	Burrows
Solastanomicon/&HalflingSurName19Title	Ambershaker
Solastanomicon/&HalflingSurName20Title	Millbridge
Solastanomicon/&HalflingSurName9Title	Tosscobble
Solastanomicon/&HumanFemaleName10Title	Reyna
Solastanomicon/&HumanFemaleName11Title	Liealia
Solastanomicon/&HumanFemaleName12Title	Dasia
Solastanomicon/&HumanFemaleName13Title	Delilah
Solastanomicon/&HumanFemaleName14Title	Payton
Solastanomicon/&HumanFemaleName15Title	Vinka
Solastanomicon/&HumanFemaleName16Title	Natascha
Solastanomicon/&HumanFemaleName17Title	Rose
Solastanomicon/&HumanFemaleName18Title	Marisol
Solastanomicon/&HumanFemaleName19Title	Juliette
Solastanomicon/&HumanFemaleName20Title	Elaine
Solastanomicon/&HumanFemaleName21Title	Barbara
Solastanomicon/&HumanFemaleName22Title	Dawn
Solastanomicon/&HumanFemaleName23Title	Harriet
Solastanomicon/&HumanFemaleName24Title	Lila
Solastanomicon/&HumanFemaleName25Title	Candace
Solastanomicon/&HumanFemaleName26Title	Claudia
Solastanomicon/&HumanFemaleName27Title	Deborah
Solastanomicon/&HumanFemaleName28Title	Diana
Solastanomicon/&HumanFemaleName29Title	Dinah
Solastanomicon/&HumanFemaleName30Title	Drusilla
Solastanomicon/&HumanFemaleName31Title	Eden
Solastanomicon/&HumanFemaleName32Title	Elisha
Solastanomicon/&HumanFemaleName33Title	Elizabeth
Solastanomicon/&HumanFemaleName34Title	Esther
Solastanomicon/&HumanFemaleName35Title	Jesse
Solastanomicon/&HumanFemaleName36Title	Julia
Solastanomicon/&HumanFemaleName37Title	Leah
Solastanomicon/&HumanFemaleName38Title	Lilith
Solastanomicon/&HumanFemaleName39Title	Lydia
Solastanomicon/&HumanFemaleName40Title	Miriam
Solastanomicon/&HumanFemaleName41Title	Naomi
Solastanomicon/&HumanFemaleName42Title	Priscilla
Solastanomicon/&HumanFemaleName43Title	Rachel
Solastanomicon/&HumanFemaleName9Title	Marcelina
Solastanomicon/&HumanMaleName14Title	Lincoln
Solastanomicon/&HumanMaleName15Title	Roy
Solastanomicon/&HumanMaleName16Title	Michael
Solastanomicon/&HumanMaleName17Title	Asher
Solastanomicon/&HumanMaleName18Title	William
Solastanomicon/&HumanMaleName19Title	Austin
Solastanomicon/&HumanMaleName20Title	Robert
Solastanomicon/&HumanMaleName21Title	Ben
Solastanomicon/&HumanMaleName22Title	Ian
Solastanomicon/&HumanMaleName23Title	Edwin
Solastanomicon/&HumanMaleName24Title	Aaron
Solastanomicon/&HumanMaleName25Title	Adam
Solastanomicon/&HumanMaleName26Title	Caleb
Solastanomicon/&HumanMaleName27Title	Daniel
Solastanomicon/&HumanMaleName28Title	Darius
Solastanomicon/&HumanMaleName29Title	Eli
Solastanomicon/&HumanMaleName30Title	Ethan
Solastanomicon/&HumanMaleName31Title	Gabriel
Solastanomicon/&HumanMaleName32Title	Gideon
Solastanomicon/&HumanMaleName33Title	Gomer
Solastanomicon/&HumanMaleName34Title	Jacob
Solastanomicon/&HumanMaleName35Title	Jadon
Solastanomicon/&HumanMaleName36Title	Linus
Solastanomicon/&HumanMaleName37Title	Luke
Solastanomicon/&HumanMaleName38Title	Mark
Solastanomicon/&HumanMaleName39Title	Nicolas
Solastanomicon/&HumanMaleName40Title	Silas
Solastanomicon/&HumanMaleName41Title	Uriah
Solastanomicon/&HumanSurName14Title	Cooper
Solastanomicon/&HumanSurName15Title	Tailor
Solastanomicon/&HumanSurName16Title	Tanner
Solastanomicon/&HumanSurName17Title	Smith
Solastanomicon/&HumanSurName18Title	Collier
Solastanomicon/&HumanSurName19Title	Miller
Solastanomicon/&HumanSurName20Title	Farrier
Solastanomicon/&SylvanElfFemaleName11Title	Sionia
Solastanomicon/&SylvanElfFemaleName12Title	Taeral
Solastanomicon/&SylvanElfFemaleName13Title	Alais
Solastanomicon/&SylvanElfFemaleName14Title	Kilyn
Solastanomicon/&SylvanElfFemaleName15Title	,Alenia
Solastanomicon/&SylvanElfFemaleName16Title	Tannyll
Solastanomicon/&SylvanElfFemaleName17Title	Elaith
Solastanomicon/&SylvanElfFemaleName18Title	Kaylessa
Solastanomicon/&SylvanElfFemaleName19Title	Ioelena
Solastanomicon/&SylvanElfFemaleName20Title	Iefyr
Solastanomicon/&SylvanElfFemaleName21Title	Adriel
Solastanomicon/&SylvanElfFemaleName22Title	Carshena
Solastanomicon/&SylvanElfFemaleName23Title	Cherith
Solastanomicon/&SylvanElfFemaleName24Title	Damarie
Solastanomicon/&SylvanElfFemaleName25Title	Delilah
Solastanomicon/&SylvanElfFemaleName26Title	Diana
Solastanomicon/&SylvanElfFemaleName27Title	Gennesaret
Solastanomicon/&SylvanElfFemaleName28Title	Habazziniah
Solastanomicon/&SylvanElfFemaleName29Title	Hilkiah
Solastanomicon/&SylvanElfFemaleName30Title	Ibri
Solastanomicon/&SylvanElfFemaleName31Title	Imri
Solastanomicon/&SylvanElfFemaleName32Title	Jezreel
Solastanomicon/&SylvanElfFemaleName33Title	Lasea
Solastanomicon/&SylvanElfFemaleName34Title	Lystra
Solastanomicon/&SylvanElfFemaleName35Title	Mara
Solastanomicon/&SylvanElfFemaleName36Title	Moriah
Solastanomicon/&SylvanElfFemaleName37Title	Morwenna
Solastanomicon/&SylvanElfFemaleName38Title	Patara
Solastanomicon/&SylvanElfFemaleName39Title	Rakal
Solastanomicon/&SylvanElfFemaleName40Title	Sapphira
Solastanomicon/&SylvanElfFemaleName41Title	Terah
Solastanomicon/&SylvanElfMaleName11Title	Ganamede
Solastanomicon/&SylvanElfMaleName12Title	Hagred
Solastanomicon/&SylvanElfMaleName13Title	Farryn
Solastanomicon/&SylvanElfMaleName14Title	Vaeril
Solastanomicon/&SylvanElfMaleName15Title	Ehlark
Solastanomicon/&SylvanElfMaleName16Title	Aymer
Solastanomicon/&SylvanElfMaleName17Title	Navarre
Solastanomicon/&SylvanElfMaleName18Title	Ilvisar
Solastanomicon/&SylvanElfMaleName19Title	Folas
Solastanomicon/&SylvanElfMaleName20Title	Gorwin
Solastanomicon/&SylvanElfMaleName21Title	Archelaus
Solastanomicon/&SylvanElfMaleName22Title	Dalphon
Solastanomicon/&SylvanElfMaleName23Title	Demetrius
Solastanomicon/&SylvanElfMaleName24Title	Dothan
Solastanomicon/&SylvanElfMaleName25Title	Eglah
Solastanomicon/&SylvanElfMaleName26Title	Elmodam
Solastanomicon/&SylvanElfMaleName27Title	Elon
Solastanomicon/&SylvanElfMaleName28Title	Esek
Solastanomicon/&SylvanElfMaleName29Title	Festus
Solastanomicon/&SylvanElfMaleName30Title	Gerar
Solastanomicon/&SylvanElfMaleName31Title	Golan
Solastanomicon/&SylvanElfMaleName32Title	Hadad
Solastanomicon/&SylvanElfMaleName33Title	Haran
Solastanomicon/&SylvanElfMaleName34Title	Harod
Solastanomicon/&SylvanElfMaleName35Title	Hothir
Solastanomicon/&SylvanElfMaleName36Title	Malluch
Solastanomicon/&SylvanElfMaleName37Title	Matthias
Solastanomicon/&SylvanElfMaleName38Title	Obed
Solastanomicon/&SylvanElfMaleName39Title	Silvanus
Solastanomicon/&SylvanElfMaleName40Title	Zeresh
Solastanomicon/&SylvanElfSurName11Title	Greystag
Solastanomicon/&SylvanElfSurName12Title	Whitehart
Solastanomicon/&SylvanElfSurName13Title	Oakheart
Solastanomicon/&SylvanElfSurName14Title	Thistlewood
Solastanomicon/&SylvanElfSurName15Title	Slenderbough
Solastanomicon/&SylvanElfSurName16Title	Shadowbrook
Solastanomicon/&SylvanElfSurName17Title	Blueneedle
Solastanomicon/&SylvanElfSurName18Title	Turningleaf
Solastanomicon/&SylvanElfSurName19Title	Dunhawk
Solastanomicon/&SylvanElfSurName20Title	Hollyblossom